NO ./img/ruta_a_la_textura_norte.xpm
SO ./img/ruta_a_la_textura_sur.xpm
WE ./img/ruta_a_la_textura_oeste.xpm
EA ./img/ruta_a_la_textura_este.xpm


F 220,0,2
C 225,30,2

11111111111111111111111111111
10000000001100000000000000001
10110000011100000000000010001
10010000000000000000000010001
10110000011100000000000010001
10000000001100000111011110001
11110111111111011100000010001
11110111111111011101010010001
11000000110101011100000010001
10000000000000001100000010001
10000000000000001100010000001
11000000110101000000000000001
11110111110101000000000000001
10000000001100000100000010001
10000000000000000000000001001
10000000001000010000000001001
10000000001101000000000000001
100000000001000000010100N0001
11111111111111111111111111111