NO ./img/ruta_a_la_textura_norte
SO ./img/ruta_a_la_textura_sur
WE ./img/ruta_a_la_textura_oeste
EA ./img/ruta_a_la_textura_este


F 220,100,0
C 225,30,0

                  111
        111111 1111111111111111111
        100001 100110000000011101
        101101 101110000001111111
        100101 100000000001
11111111101101 1011100000011
10000000001101 1011101111111111
11110111111111 11100000010111
11110111 11111 111010100111
11000001 10101 1110000001
10001111 10001 111000000111
10001    10001111101010010111
11001111 1010111111011110N0111
11110111 111011   1101111010011
11111111 111111   111111111111
                             111111
