NO ./img/ruta_a_la_textura_norte
SO ./img/ruta_a_la_textura_sur
WE ./img/ruta_a_la_textura_oeste
EA ./img/ruta_a_la_textura_este


F 220,100,0
C 225,30,0

111111111
1000N0001
111000101
100000111
100000111
111111111